AIS = "countries/Aishna.txt"
ANY = "countries/Anyang country.txt"
AKU = "countries/Republic of Akuya.txt"
ART = "countries/northern part of the country.txt"
BER = "countries/Berez.txt"
COU = "countries/country of rest.txt"
DUC = "countries/Duchy of Ryan.txt"
DIV = "countries/Divine Land.txt"
ENU = "countries/Venus.txt"
ETE = "countries/eternal country.txt"
ELT = "countries/Melt iron city.txt"
EIN = "countries/Ein clan.txt"
FEN = "countries/Fen burning country.txt"
FAL = "countries/kingdom of flange.txt"
FRO = "countries/Frost Wolf clan.txt"
GOD = "countries/Lo god port.txt"
GUS = "countries/Duchy of Gusibra.txt"
HAS = "countries/Haspev.txt"
IRA = "countries/Flanty Pirates.txt"
KAT = "countries/Katiya Federal.txt"
KAN = "countries/Wei Kangguo.txt"
KIA = "countries/Shakla Kingdom.txt"
KAY = "countries/Kayla clan.txt"
LOV = "countries/Lovinia.txt"
LOR = "countries/Lorinia.txt"
LOB = "countries/Colony of Lobonia.txt"
LIV = "countries/Live a wasteland.txt"
LEG = "countries/legion.txt"
MOB = "countries/mobis Empire.txt"
MAG = "countries/Magic girl alliance.txt"
MOO = "countries/Moon shadow clan.txt"
MIC = "countries/Microglia clan.txt"
MIY = "countries/kingdom of miya.txt"
NEW = "countries/New sta country.txt"
NGD = "countries/kingdom of chilla.txt"
NED = "countries/Republic of Nedland.txt"
NAN = "countries/Nan Wei An Ping Jun.txt"
ORD = "countries/Royal Order.txt"
ORT = "countries/North fox clan.txt"
ONG = "countries/Dong Wei dingyang army.txt"
OLI = "countries/holy country of dusk.txt"
OME = "countries/Kingdom of Komear.txt"
PEC = "countries/Pecchiti.txt"
POS = "countries/Posalian.txt"
PIR = "countries/Falcon legion.txt"
RED = "countries/redei army.txt"
ROA = "countries/Royalty of Lovinia.txt"
REP = "countries/Republic of Garance.txt"
RUT = "countries/Ruther federal.txt"
RAS = "countries/Corras.txt"
RIE = "countries/Riesnia.txt"
STA = "countries/Sta kingdom.txt"
SUP = "countries/SuperAncient Defense Agreement.txt"
SNO = "countries/Snow and snow.txt"
SHE = "countries/ShengYang empire.txt"
SOU = "countries/southern part of the country.txt"
SHA = "countries/Shangri-la.txt"
TZY = "countries/tzynn empire.txt"
TOM = "countries/kingdom of Tomenia.txt"
UNI = "countries/Union of Artisan.txt"
WIM = "countries/wing god religion.txt"
WIN = "countries/Wing legion.txt"
WEI = "countries/Northern Wei Rin Dong Jun.txt"
ZET = "countries/De Zet Federal.txt"
ZHI = "countries/Western Wei Zhiyuan army.txt"
FAR = "countries/reaml of Farr.txt"
BSP = "countries/Broken soul port.txt"
